8 8 4

0006 0001 0001 0001 0001 0001 0024 0016
0003 0019 0000 0000 0000 0016 0023 0004
0003 0000 0023 0016 0000 0024 0000 0004
0003 0000 0000 0000 0000 0016 0000 0004
0003 0000 0000 0022 0016 0021 0000 0004
0003 0000 0000 0016 0016 0000 0000 0004
0003 0000 0022 0020 0000 0000 0025 0004
0008 0002 0002 0002 0002 0002 0020 0016

0015 0015 0015 0015 0015 0015 0015 0015
0015 0015 0015 0015 0015 0015 0015 0015
0015 0015 0015 0015 0015 0015 0015 0015
0015 0015 0015 0015 0015 0015 0015 0015

0015 0015 0015 0015 0015 0015 0015 0015
0015 0015 0015 0015 0015 0015 0015 0015
0015 0015 0015 0015 0015 0015 0015 0015
0015 0015 0015 0015 0015 0015 0015 0015

120 120 0
0 0 0
0 1 1