8 8 4

0006 0001 0001 0001 0001 0001 0001 0007
0016 0020 0018 0000 0000 0000 0000 0004
0022 0000 0000 0000 0000 0000 0000 0004
0016 0000 0016 0000 0000 0000 0000 0004
0017 0020 0016 0000 0000 0000 0000 0004
0023 0000 0000 0000 0000 0000 0000 0019
0003 0000 0027 0000 0000 0000 0000 0004
0008 0002 0002 0002 0002 0002 0002 0009

0015 0015 0015 0015 0015 0015 0015 0015
0015 0015 0015 0015 0015 0015 0015 0015
0015 0015 0015 0015 0015 0015 0015 0015
0015 0015 0015 0015 0015 0015 0015 0015

0015 0015 0015 0015 0015 0015 0015 0015
0015 0015 0015 0015 0015 0015 0015 0015
0015 0015 0015 0015 0015 0015 0015 0015
0015 0015 0015 0015 0015 0015 0015 0015

120 120 0
0 0 0
0 1 1