8 8 4

0006 0001 0001 0001 0001 0001 0001 0007
0003 0000 0000 0000 0000 0000 0000 0004
0003 0000 0000 0000 0000 0000 0000 0004
0003 0000 0000 0018 0000 0000 0000 0004
0003 0000 0000 0000 0000 0019 0000 0004
0003 0000 0000 0000 0000 0000 0000 0004
0003 0000 0000 0000 0000 0000 0000 0004
0008 0002 0002 0002 0002 0002 0002 0009

0015 0015 0015 0015 0015 0015 0015 0015
0015 0015 0015 0015 0015 0015 0015 0015
0015 0015 0015 0015 0015 0015 0015 0015
0015 0015 0015 0015 0015 0015 0015 0015

0015 0015 0015 0015 0015 0015 0015 0015
0015 0015 0015 0015 0015 0015 0015 0015
0015 0015 0015 0015 0015 0015 0015 0015
0015 0015 0015 0015 0015 0015 0015 0015

80 80 0
0 0 0
0 1 1 

