8 8 4

0022 0001 0001 0001 0001 0001 0001 0024
0022 0000 0000 0000 0000 0000 0000 0024
0022 0000 0020 0020 0020 0000 0000 0024
0022 0000 0020 0018 0020 0000 0000 0024
0022 0000 0020 0020 0020 0000 0000 0024
0022 0000 0000 0023 0000 0000 0000 0024
0022 0000 0022 0020 0024 0000 0000 0024
0022 0002 0002 0021 0002 0002 0002 0024

0015 0015 0015 0015 0015 0015 0015 0015
0015 0015 0015 0015 0015 0015 0015 0015
0015 0015 0015 0015 0015 0015 0015 0015
0015 0015 0015 0015 0015 0015 0015 0015

0015 0015 0015 0015 0015 0015 0015 0015
0015 0015 0015 0015 0015 0015 0015 0015
0015 0015 0015 0015 0015 0015 0015 0015
0015 0015 0015 0015 0015 0015 0015 0015

120 120 0
0 0 0
0 1 1